1 bath	                baño
2 bathroom	            baño
3 bath mat	            alfombra de baño
4 bath salts	        sales de baño
5 bath towel	        toallón
6 bidet	                bidé
7 cold water	        agua fría
8 cold water tap	    grifo de agua fría
9 comb	                peine
10 drain	            desagüe
11 faucet 	            grifo, canilla
12 the Gents 	        baño público de hombres
13 hairbrush	        cepillo para cabello
14 hairdryer	        secador de cabello
15 hand towel	        toalla de mano
16 hot water	        agua caliente
17 hot water tap	    grifo de agua caliente
18 the Ladies	        baño público de damas
19 lavatory 	        lavabo
20 loo                  informal baño
21 medicine chest	    botiquín
22 mirror	            espejo
23 nailbrush	        cepillo para uñas
24 public conveniences	baño público
25 razor	            maquinilla de afeitar
26 electric razor	    máquina de afeitar (eléctrica)
27 restroom 	        baño público
28 scales	            balanza
29 shampoo	            champú

30 shaver	máquina de afeitar (eléctrica)
31 shaving cream	crema de afeitar
32 shower	ducha
33 soap	jabón
34 soap tray	jabonera
35 sponge	esponja
36 tap (UK)	grifo, canilla
37 toilet	inodoro
38 toilet	baño
39 toilets	baño público
40 toilet paper	papel higiénico
41 toilet roll	rollo de papel higiénico
42 toiletries	artículos de tocador
43 toothbrush	cepillo de dientes
44 toothpaste	pasta dentífrica
45 towel	toalla
46 towel rack	toallero
47 tub	bañera
48 washroom (US)	baño público
49 WC (UK), old use	baño
50 to brush one's hair	cepillarse el cabello
51 to brush one's nails	cepillarse las uñas
52 to brush one's teeth	cepillarse los dientes
53 to comb one's hair	peinarse
54 to take a bath	tomar un baño
55 to take a shower	tomar una ducha
56 to shave	afeitarse
57 to wash oneself	lavarse
58 to wash one's hands	lavarse las manos